***X*X*X*X*X*X*X*X*X*
XX*X*X*X*X*X*X***X***
***X*X*****X***X***X*
XX*X*XXXXX*XX*XXXXXXX
***X***X*********X***
XX*X*X*X*XXXXXXX***XX
*****X*X*X*X***X*X***
XXX*XXXX*X*X*XXX*XXX*
*****X*X***X***X***X*
XXX*XX*XXX*X*XXX*XXX*
*********X*X*****X*X*
XXXX*X*XXX*XXX*XXX*XX
*****X***X***X*******
XX*XXX*XXXXXXX*X*X*X*
*****X*****X***X*X*X*
XXXXXXXX*XXXXXXXXX*X*
*****X*X*X*****X***X*
X*XXXX*X*X*X*XXX*X*XX
*****X*****X*****X***
XXX*XXXXXX*XXXX*XX*XX
***********X*****X***
